5
Level1
11111111101100000000110111011110011101111011110000000001010111110001011000011100101100011110111101nn
Level2
11111111101000000010101111100000111110111011000000100001110111101111010000001100100110011111111101nn
Level3
11111111111110000000100011011000100101101111000000111111011111111000111111001000100001111110101111nn
Level4
11111111111111111111111111111111111111111111000000111101111111110111111111011111111101111111110111nn
Level5
11111111111111111111111111111111111111111111110000111111011111111101111111110111111111011111111101nn
